0000000000000000000000000002
0000000000000000000000000002
0000000000000000000000000002
0000000000000000000000000002
0000000000001110001111100002
0000000111000000001000000002
0000000000000000001000000002
0000000000000000001000000002