0000000000000000000000000002
0000000000000000000000000002
0000000000000000001111100002
0000000000000000000000000002
0000000000001110000000000002
0000000111000000000000000002
0000000000000000000000000002
0000000000000000000000000002